0
7
5
#######
#.   @#
#  .  #
#  .  #
#######
