1
35
17
###################################
#                                 #
#                                 #
#   #   # ##### #     #     ##### #
#   #   # #     #     #     #  .# #
#   #   # #     #     #     #   # #
#   #   # #.    #     #         # #
#   ##### ####  #     #     #   # #
#   #   # #     #     #     #   # #
#   #   # #     #     #     #   # #
#  .#   # ##### ##### ##### ##### #
## ####                           #
#     #                           #
#            #                    #
#    .#      # #                  #
#@    #.     #      #        .    #
###################################
