0
29
14
#############################
#@ #         #    #     ## .#
#  #  #   #  #    #  #  #  ##
#  # .#   #  #    #. #  ##  #
#  ####   #  #    ####  #   #
#       ##   #          # ###
#  #         #          #   #
#  #         #    ######### #
#  #.        #    #     #   #
#  ######    #    # #   # ###
#     #.#    #    # #   #   #
#  #  # #    #    # # ##### #
#  #    #           #       #
#############################
